NO textures/redbrick.xpm
EA textures/bluestone.xpm
WE textures/eagle.xpm
SO textures/purplestone.xpm

C 14,22,23
F 55,55,55

11111111111111111111111111111111         111111111111111111
1E0000000000000000110000000000001        100000000011000000111111
111101100011111111110000000000001        1011000001110000000000001
100001100010000000000000000000001        1001000000000000000000001
100000111011000001110000000000001111111111011000001110000000000001
100000000000000000000000000000000000000000000000000000000000000001
111101111111110111000000100001110000111111110111000000100010100011
111101111111110111010100100011110111111111101110101001000101000101
111111111101010111000000101011100010011010101110000001000101000101
        1000000011000000100000000000000000000110000001000101000101
111111111000000011010100100011000000000000000110101001000101000101
110000011101010111110111100011110000111110101111110111101111101111
11110111 1110101 10111101000111100111 1110101 101111010001010001
11111111 1111111 11111111111111101111 1111111 11111111111111111111
11111111 1111111 11111111111111101111 1111111 11111111111111111111
111101111111110111000000100011100001111111101110000001000101000101
111101111111110111010100100011110111111111101110101001000101000101
110000000000000000000000101011100010011010101110000001000101000101
100000000000000011000000100011000000000000000110000001000101000101
100000000000000011010100101011000000000000000110101001000101000101
110000011101010111110111100011110000111110101111110111101111101111
10110111 1110101 10111101000111100111 1110101 10111101000101001001
11111111 1111111 11111111111111111111 1111111 11111111111111111111
